4 5 3 2 0 4
+-+-+-+-+-+
|         |
+-+ + + +-+
|         |
+-+ + + +-+
|         |
+-+ + + +-+
|         |
+-+-+-+-+-+