4 5 0 0 3 4
+-+-+-+-+-+
|   |     |
+-+ + +-+-+
|     |   |
+ +-+-+ +-+
| |       |
+ +-+ + +-+
|     |   |
+-+-+-+-+-+