4 4 3 2 0 0
+-+-+-+-+
|   |   |
+-+ + +-+
|       |
+ +-+-+ +
| |     |
+ +-+ + +
|   | | |
+-+-+-+-+